1111111
1P0EC01
1000001
1111111