1111111
1P1E101
1001C01
1111111