11111111111111111111
10000000E10000000001
100000C0000000000001
100C0000000000000001
10000000000000000001
1000000000P000000001
10000000000000000001
10000000000000000001
10000000000000000001
11111111111111111111